DDDDDDDDDDDDDDDDDDDDDDDDDDDDDDDDDDDDDDDDDDDDDDDDDDD
DDDDDDDDDDDDDDDDDDDDDDDDDDDDDDDDDDDDDDDDDDDDDDDDDDD
DDDDDDDDDDDDDDDDDDDDDDDDDDDDDDDDDDDDDDDDDDDDDDDDDDD
DDDDDDDDDDDDDDDDDDDDDDDDDDDDDDDDDDDDDDDDDDDDDDDDDDD
DDDDDDDDDDDDDDDDDDDDDDDDDDDDDDDDDDDDD-DDDDDDDDDDDDD
DDDDDDDDDDDDDDDDDDDDDDDDDDDDDDDDDDDDD-DDDD----DDDDD
DDDDDDDDDD----------------------------DD--DD---DDDD
DDDDDDDDDDDDDDDDDDDDDDDDDDDDDDDDDDDDD-D--DDD-D-DDDD
DDDDDDDDDDDDDDDDDDDDDDDDDDDDDDDDDDDDD-DDDDD--D-DDDD
DDDDDDDDDDDDDDDDDDDDD-------DDDDDDDDD-DDDDD--D--DDD
DDDDDDDDDDDDDDDDDDDD--DDDDD--DDDDDDDD-DDDDD-DD--DDD
DDDDDDDDDDDDDDDDDDD--DDDDDDDDDDDDDDDD-DDDD--DD--DDD
DDDDDDDDDDDDDDDDDDD-DDDDDDDDDDDDDDDDD-DDDD--DD--DDD
DDDDDDDDDDDDDDDDDD-DDDDDDDDDDDDDDDDDD-DDDD--D---DDD
DDDDDDDDDDDDDDDDDD-DDDDDDDDDDDD-DDDDD-DDDDD----DDDD
DDDDDDDDDDDDDDDDDD-DDDDDDDDDDDD-DDDDD-DDDDD----DDDD
DDDDDDDDDDDDDDDDD-DDDDDDDDDDDDD-DDDDD-DDDDDDDDDDDDD
DDDDDDDDDDDDDDDDDD-DDDDDDDDDDD--DDDDD-DDDDDDDDDDDDD
DDDDDDDDDDDDDDDDDD-DDDDDDDDDDD-DDDDDD-DDDDDDDDDDDDD
DDDDDDDDDDDDDDDDDD-DDDDDDDDDD-DDDDDDD-DDDDDDDDDDDDD
DDDDDDDDDDDDDDDDDD--DDDDDDDD--DDDDDDD-DDDDDDDDDDDDD
DDDDDDDDDDDDDDDDDDD--DDDDDD--DDDDDDDD-DDDDDDDDDDDDD
DDDDDDDDDDDDDDDDDDDD--DDD---DDDDDDDDD-DDDDDDDDDDDDD
DDDDDDDDDDDDDDDDDDDDDD----DDDDDDDDDDD-DDDDDDDDDDDDD
DDDDDDDDDDDDDDDDDDDDDDDDDDDDDDDDDDDDD-DDDDDDDDDDDDD
DDDDDDDDDDDDDDDDDDDDDDDDDDDDDDDDDDDDD-DDDDDDDDDDDDD
DDDDDDDDDDDDDDDDDDDDDDDDDDDDDDDDDDDDD-DDDDDDDDDDDDD
DDDDDDDDDDDDDDDDDDDDDDDDDDDDDDDDDDDDD-DDDDDDDDDDDDD
DDDDDDDDDDDDDDDDDDDDDDDDDDDDDDDDDDDDD-DDDDDDDDDDDDD
DDDDDDDDDDDDDDDDDDDDDDDDDDDDDDDDDDDDDDDDDDDDDDDDDDD
DDDDDDDDDDDDDDDDDDDDDDDDDDDDDDDDDDDDDDDDDDDDDDDDDDD
DDDDDDDDDDDDDDDDDDDDDDDDDDDDDDDDDDDDDDDDDDDDDDDDDDD
