DDDDDDDDDDDDDDDDDDDDDDDDDDDDDDDDDDDDDDDDDDDDDDDDDDD
DDDDDDDDDDDDDDDDDDDDDDDDDDDDDDDDDDDDDDDDDDDDDDDDDDD
DDDD----DDDDDD--DDDDDDDDDDDDDDDDDDDDDD---DDDDDDDDDD
DDDD-DD--DDDDD--DDDDDDD-DDDDD-DDDDDDD--D-DDDDDDDDDD
DDDD-DDD--DDDD---DDDDDD-DDDDD-DDDDDD--DD-DDDDDDDDDD
DDDD-DDD--DDDD-D-DDDDDD-DDDDD-DDDDDD-DDD-DDDDDDDDDD
DDDD----DDDDD--D--DDDDD-DDDDD-DDDDDD-DDD-DDDDDDDDDD
DDDD-----DDDD-DDD-DDDDD----DD-DDDDDD--DD-DDDDDDDDDD
DDDD-DDD-DDDD-----DDDDD--D----DDDDDDD----DDDDDDDDDD
DDDD-DDD--DDD-DDD--DDDDD-DDDD-DDDDDDD--D-DDDDDDDDDD
DDD--DDDD-DDD-DDDD-DDDDD-DDDD-DDDDDD--DD-DDDDDDDDDD
DDDD------DD-DDDDD--DDDD-DDDD-DDDDD--DDD-DDDDDDDDDD
DDDDDDDDDDDDDDDDDDDDDDDD-DDDD--DDD--DDDD-DDDDDDDDDD
DDDDDDDDDDDDDDDDDDDDDDDDDDDDDD-DDD-DDDDD-DDDDDDDDDD
DDDDDDDDDDDDDDDDDDDDDDDDDDDDDD-DD--DDDDDDDDDDDDDDDD
DDDDDDDDDDDDDDDDDDDDDDDDDDDDDDDDDDDDDDDDDDDDDDDDDDD
DDDDDDDD-DDDDDDDDDDDDDDD--------DDDDDDDDDDDDDDDDDDD
DDDDDDD--DDDDDDDDDDDDDDD-DDDDDDDDDDDDDDDDDDDDDDDDDD
DDDDDDD---DDDDDDDDDDDDDD-DDDDDDDDDDDDDDDDDDDDDDDDDD
DDDDDDD-D-DDDDDDDDDDDDDD-DDDDDDDDDDDDDDDDDDDDDDDDDD
DDDDDD-DD-DDDDDDDDDDDDDD-DDDDDDDDDDDDDDDDDDDDDDDDDD
DDDDD--DDD-DDDDDDDDDDDDD-DDDDDDDDDDDDDDDDDDDDDDDDDD
DDDDD-DDDD--DDDDDDDDDDDD---------DDDDDDDDDDDDDDDDDD
DDDDD-DDDDD-DDDDDDDDDDDD--DDDDDD----DDDDDDDDDDDDDDD
DDDDD-DDDDD--DDDDDDDDDDDD-DDDDDDDDD--DDDDDDDDDDDDDD
DDDD--DDDDDD--DDDDDDDDDDD-DDDDDDDDDD-DDDDDDDDDDDDDD
DDDD-DDDDDDDD-DDDDDDDDDDD-DDDDDDDDDD--DD--DDDDDDDDD
DDDD-DDDDDDDD--DDD--DDDDD-DDDDDDDDDD--DD---DDDDDDDD
DDDDDDDDDDDDDD-DDD--DDDDD---DDDDDDD--DDD--DDDDDDDDD
DDDDDD8888888888DDDDDDDDDDD--------DDDDDDDDDDDDDDDD
D888888DDDDDDDD88888888DDDDDDDDDDDDDDDDDDDDDDDDDDDD
DDDDDDDDDDDDDDDDDDDDDDD8888888888888888888888888DDD
