DDDDDD-D-D-D-DDD-DDDDDDD-D-DDDDD-DDDDD-D-D-DDDDDDDD
DDDDDD-D-D-D-DDD-DDDDDDD-D-DDDDD-DDDDD-D-D-DDDDDDDD
---D---D-D-D-D---D---D---D---D---D---D-D-D-DDD-D--D
DD-D-DDD-DDDDD-DDDDDDD-D-D-D-D-D-DDDDDDD-DDDDD-DDDD
DD-D-D-D-D-DDD-DDDDD-D-D-D-D-D-D-D---D-------D---DD
DD-DDD-D-D-DDDDDDDDD-D-DDD-DDD-DDDDD-DDD-DDDDDDD-DD
DD-D---D-------D---D-D---D---D-D-D---D-D-D---D----D
DD-DDDDDDDDD-D-DDDDDDD-DDDDD-D-D-D-DDD-D-D-DDDDD-DD
DD-D---------D---D---D-D-----D---D-DDD-D-D-----D-DD
DDDD-DDD-DDDDDDDDD-DDDDD-DDD-DDD-DDDDDDD-DDDDD-D-DD
---D---D---D-----D-D-----------D---D-D-------D-D-DD
DD-DDD-DDD-D-DDD-D-D-D-D-------D-DDD-DDDDD-D-D-D-DD
DD---D---D-----D-D-D-D---------D-D---DDDDD-D-D-D--D
DD-DDDDDDDDDDDDD-DDD-D--------DD-D-D-DDDDDDDDD-D-DD
DD-D---DDD-----D-D---D-----------D-D---D---D---D-DD
DD-D-D-DDD-DDDDD-D-D-D----DD--DDDDDD-DDD-DDD-DDD-DD
DD-D-D---D-----D-D-D-----------D---D---D-D-----D--D
DD-D-DDD-D-D-DDD-DDD-D----D-D-DD-DDD-D-D-DDD-D-D-DD
DD---DDD-D-D-D---------------------D-D-D-D-D-D-D-DD
DD-D-DDD-D-DDDDDDDD---------DD-DDDDD-D-DDD-D-D-DDDD
DD-D---D-D-DDD-----D-D-----------D---D-D-D-D-D-DDDD
DDDD-DDDDD-DDDDDDD-DDDDDDDDD-DDD-D-D-DDD-D-DDD-DDDD
---D-D-----D-D-D-----D-DDD-D---D-D-D-D-D-D-DDD-DDDD
DDDDDD-D-D-D-D-D-D-D-D-DDD-D-DDDDD-DDD-D-D-DDDDDDDD
-----D-D-D-D-D-D-D-D-D-D-D---D-----D---D-D---DDD-DD
DDDD-DDDDD-D-D-DDDDDDD-D-D-D-D-D-D-D-D-D-D-D-DDD-DD
---D-----D-------------D---D-D-D-D-D-D-D-D-D-----DD
DDDDDDDD-DDD-DDD-DDD-D-D-D-D-DDDDD-D-DDDDD-D-D-D-DD
DD-----D---D-D-----D-D-D-D-D-----D-D-DDD-D-D-D-D-DD
DDDD-D-D-DDDDDDD-D-D-D-D-D-D-D-D-DDDDDDD-DDDDD-D-DD
DDDD-D-------DDD-D-D-D-D-D-D-D-D---D---D-D---D-D-DD
DDDDDDDDDDDDDDDDDDDDDDDDDDDDDDDDDDDDDDDDDDDDDDDDDDD
