DDDDDDDDDDDDDDDDDDDDDDDDDDDDDDDDDDDDDDDDDDDDDDDDDDD
DDDDDDDDDDDDDDDDDDDDDDDDDDDDDDDDDDDDDDDDDDDDDDDDDDD
DDDDDDDDDDDDDDDDDDDDDDDDDDDDDDDDDDDDDDDDDDDDDDDDDDD
DDDDDDDDDDDDDDDDDDDDDDDDDDDDDDDDDDDDDDDDDDDDDDDDDDD
DDDDDDDDDDDDDDDDDDDDDDDDDDDDDDDDDDDDDDDDDDDDDDDDDDD
DDDDDDDDDDDDDDD8888DDDDDDDDDDD888DDDDDDDDDDDDDDDDDD
DDDDDDDDDDDDDD88DD888DDDDDDD88DDD88DDDDDDDDDDDDDDDD
DDDDDDDDDDDDD88DDDDD88DDDDD88DDDDD88DDDDDDDDDDDDDDD
DDDDDDDDDDDDD8DDDDDDDD8DDDD8DDDDDDD8DDDDDDDDDDDDDDD
DDDDDDDDDDDD88DDDDDDDDD8DDD8DDDDDDDD8DDDDDDDDDDDDDD
DDDDDDDDDDDD8DDDDDDDDDD88888DDDDDDDD8DDDDDDDDDDDDDD
DDDDDDDDDDDD8DDDDDDDDDDD88DDDDDDDDDD8DDDDDDDDDDDDDD
DDDDDDDDDDDD8DDDDDDDDDDD8DDDDDDDDDDD8DDDDDDDDDDDDDD
DDDDDDDDDDDD8DDDDDDDDDDD8DDDDDDDDDDD8DDDDDDDDDDDDDD
DDDDDDDDDDDD8DDDDDDDDDDDDDDDDDDDDDD88DDDDDDDDDDDDDD
DDDDDDDDDDDD88DDDDDDDDDDDDDDDDDDDD88DDDDDDDDDDDDDDD
DDDDDDDDDDDDD8DDDDDDDDDDDDDDDDDDD88DDDDDDDDDDDDDDDD
DDDDDDDDDDDDD8DDDDDDDDDDDDDDDDDD88DDDDDDDDDDDDDDDDD
DDDDDDDDDDDDD8DDDDDDDDDDDDDDDDDD8DDDDDDDDDDDDDDDDDD
DDDDDDDDDDDDD88DDDDDDDDDDDDDDDD88DDDDDDDDDDDDDDDDDD
DDDDDDDDDDDDDD8DDDDDDDDDDDDDDD88DDDDDDDDDDDDDDDDDDD
DDDDDDDDDDDDDD8DDDDDDDDDDDDDD88DDDDDDDDDDDDDDDDDDDD
DDDDDDDDDDDDDDD8DDDDDDDDDDDD88DDDDDDDDDDDDDDDDDDDDD
DDDDDDDDDDDDDDD88DDDDDDDDDDD8DDDDDDDDDDDDDDDDDDDDDD
DDDDDDDDDDDDDDDD8DDDDDDDDDD8DDDDDDDDDDDDDDDDDDDDDDD
DDDDDDDDDDDDDDDD88DDDDDDDD88DDDDDDDDDDDDDDDDDDDDDDD
DDDDDDDDDDDDDDDDD888DDDDDD8DDDDDDDDDDDDDDDDDDDDDDDD
DDDDDDDDDDDDDDDDDDD88DDD888DDDDDDDDDDDDDDDDDDDDDDDD
DDDDDDDDDDDDDDDDDDDD8DDD8DDDDDDDDDDDDDDDDDDDDDDDDDD
DDDDDDDDDDDDDDDDDDDD8888DDDDDDDDDDDDDDDDDDDDDDDDDDD
DDDDDDDDDDDDDDDDDDDDD88DDDDDDDDDDDDDDDDDDDDDDDDDDDD
DDDDDDDDDDDDDDDDDDDDDDDDDDDDDDDDDDDDDDDDDDDDDDDDDDD
