DDDDDDDDDDDDDDDDDDDDDDDDDDDDDDDDDDDDDDDDDDDDDDDDDDD
DDDDDDDDDDDDDDDDDDDDDDDDDDDDDDDDDDDDDDDDDDDDDDDDDDD
DDDDDDDDDDDDDDDDDDDDDDDDDDDDDDDDDDDDDDDDDDDDDDDDDDD
DDDDDDDDDDDDDDDDDDDDDDDDDDDDDDDDDDDDDDDDDDDDDDDDDDD
DDDDDD----------DDDDDDDDDDDDDDD------------DDDDDDDD
DDDDDDDDDDDDDDD-DDDDDDDDDDDDDDD-DDDDDDDDDDDDDDDDDDD
DDDDDDDDDDDDDDD-DDDDDDDDDDDDDDD-DDDDDDDDDDDDDDDDDDD
DDDDDDDDDDDDDDD-DDDDDDDDDDDDDDD-DDDDDDDDDDDDDDDDDDD
DDDDDDDDDDDDDDD-DDDDDDDDDDDDDDD-DDDDDDDDDDDDDDDDDDD
DDDDDDDDDDDDDDD-DDDDDDDDDDDDDDD-DDDDDDDDDDDDDDDDDDD
DDDDDDDDDDDDDDD-DDDDDDDDDDDDDDD-DDDDDDDDDDDDDDDDDDD
DDDDDDDDDDDDDDD-DDDDDDDDDDDDDDD-DDDDDDDDDDDDDDDDDDD
DDDDDDDDDDDDDDD-DDDDDDDDDDDDDDD-DDDDDDDDDDDDDDDDDDD
DDDDDDDDDDDDDDD-DDDDDDDDDDDDDDD-DDDDDDDDDDDDDDDDDDD
DDDDDDDDDDDDDDDDDDDDDDDDDDDDDDDDDDDDDDDDDDDDDDDDDDD
DDDDDDDDDDDDDDDDDDDDDDDDDDDDDDDDDDDDDDDDDDDDDDDDDDD
DDDDDDDDDDDDDDDDDDDDDDDDDDDDDDDDDDDDDDDDDDDDDDDDDDD
DDDDDDDDDDDDDDDDDDDDDDDDDDDDDDDDDDDDDDDDDDDDDDDDDDD
DDDDDDDDDDDDDDDDDDDDDDDDDDDDDDDDDDDDDDDDD-DDDDDDDDD
DDDDDD-DDDDDDDDDDDDDDDDDDDDDDDDDDDDDDDDDD-DDDDDDDDD
DDDDDD-DDDDDDDDDDDDDDDDDDDDDDDDDDDDDDDDDD-DDDDDDDDD
DDDDDD-DDDDDDDDDDDDDDDDDDDDDDDDDDDDDDDDDD-DDDDDDDDD
DDDDDD-DDDDDDDDDDDDDDDDDDDDDDDDDDDDDDDDDD-DDDDDDDDD
DDDDDD-DDDDDDDDDDDDDDDDDDDDDDDDDDDDDDDDDD-DDDDDDDDD
DDDDDD-DDDDDDDDDDDDDDDDDDDDDDDDDDDDDDDDDD-DDDDDDDDD
DDDDDD-DDDDDDDDDDDDDDDDDDDDDDDDDDDDDDDDDD-DDDDDDDDD
DDDDDD-DDDDDDDDDDDDDDDDDDDDDDDDDDDDDDDDDD-DDDDDDDDD
DDDDDD-DDDDDDDDDDDDDDDDDDDDDDDDDDDDDDDDDD-DDDDDDDDD
DDDDDD-DDDDDDDDDDDDDDDDDDDDDDDDDDDDDDDDDD-DDDDDDDDD
DDDDDD-----------------DDDDDDD------------DDDDDDDDD
DDDDDDDDDDDDDDDDDDDDDDDDDDDDDDDDDDDDDDDDDDDDDDDDDDD
DDDDDDDDDDDDDDDDDDDDDDDDDDDDDDDDDDDDDDDDDDDDDDDDDDD
