DDDDDDDDDDDDDDDDDDDDDDDDDDDDDDDDDDDDDDDDDDDDDDDDDDD
DDDDDDDDDDDDDDDDDDDDDDDDDDDDDDDDDDDDDDDDDDDDDDDDDDD
DDDDDDDDDDDDDDDDDDDDDDDDDDDDDDDDDDDDDDDDDDDDDDDDDDD
DDD--DDDDDDDDDD-DD-----DDDDDDDDD-----DDDDDDDDD-DDDD
DDDD---DDDDDDDD---DDDDDDDDDDDDD--DDDDDDDDDDD--DDDDD
DDDDDDD---DDDDDDDDDDDDDDDDDDDD--DDDDDDDDDDDDDDDDDDD
DDDDDDDDD---DDDDDDDDDDDDDDDDD--DDDDDDDDDDDDDDDDDDDD
DDDDDDDDDDD-DDDDDDDDDDDDDDDD--DDDDDDDDDDDDDD--DDDDD
DDDDDDDDDDDD-DDDDDDDD--DDDDD-DDDDDDDDDDDDDD----DDDD
DDDDDDDDDDDD--DDDDDDD-DDDDDD-DDDDDDDDDDDDDD-DD--DDD
DDDDDDDDDDDDD-DDDDDDD-DDDDDD-DDDDDDDDDDDDDDDDDD-DDD
DDDDDDDDDDDDD--DDDDDD-DDDDDDDDDDDDDDDDDDDDDDDDD-DDD
DDDDDDDDDDDDDD-DDDDDD-DDDDDDDDDDDDDDDDDDDDDDDDD-DDD
DDDDDDDDDDDDDD--DDDDD-DDDDDDDDDDDDDDDDDDDDDDDDD-DDD
DDDDDDDDDDDDDDD-DDDDDDDDDDDDDDDDDDDDDDDDDDDDDDD--DD
DDDDD-DDDDDDDDD-DDDDDDDDDDDDDDDDDDDDDDDDDDDDDDDD-DD
DDDDD-DDDDDDDDD--DDDDDDDDDDDDDDDDDDDDDDDDDDDDDDD-DD
DDDDD-DDDDDDDDDD-DDDDDDD-DDDDDDDDDDDDDDDDDDDDDDD-DD
DDDDD-DDDDDDDDDDDDDDDDDD-DDDDDDDDDDDDDDDDDDDDDDD-DD
DDDDDDDDDDDDDDDDDDDDDDDD-DDDDDDDDDDD-DDDDDDDDDDD-DD
DDDDDDDDDDDDDDDDDDDDDDDD-DDDDDDDDDDD-DDDDDDDDDDDDDD
DDDDDDDDDDDDDDDDDDDDDDDD-DDDDDDDDDDD-DDDDDDDDDDDDDD
DDDDDDDDDDDDDDDDDDDDDDDD-DDDDDDDDDDDD-DDDDDDDDDDDDD
DDDDDDDD-DDDDDDDDDDDDDDD-DDDDDDDDDDDD-DDDDDDDDDDDDD
D-DDDDDD-DDDDDDDDDDDDDDD--DDDDDDDDDDD--DDDDDDD-DDDD
D-DDDDDD--DDDDDDDDDDDDDDDDDDDDDDDDDDDD--DDD----DDDD
D-DDDDDDD--DDDDDDDDDDDDDDDDDDDDDDDDDDDD-----DDDDDDD
D--DDDDDDD--DDDDDDDDDDDDDDDDDDDDDDDDDDDDDDDDDDDDDDD
DD-DDDDDDDD--DDDDDDDDDDDDDDDDDDDDDDDDDDDDDDDDDDDDDD
DD-DDDDDDDDDD--DDDDDDDDDDDDDDDDDD-DDDDDDDDDDDDDDDDD
DDDDDDDDDDDDDDD---DDDDDDDDDDDDDDD-DDDDDDDDDDDDDDDDD
DDDDDDDDDDDDDDDDDD---------------DDDDDDDDDDDDDDDDDD
