DDDDDDDDDDDDDDDDDDDDDDDDD888DDDDDDDDDDDDDDDDDDDDDDD
DDDDDDDDDDDDDDDDDDDDDDDDD888DDDDDDDDDDDDDDDDDDDDDDD
DDDDDDDDDDDDDDDDDDDDDDDDD888DDDDDWDDDDDDDDDDDDDDDDD
DDDDDDDDDDDDDDDDDDDWDDDDDD8DDDDDDWDDDDDDDDDDDDDDDDD
DDDDDDDDDDDDDDDDDDDWDDDDDDDDDDDDDWDDDDDDD8DDDDDDDDD
DDDDDDDDDDDDD8DDDDDWDDDDDDDDDDDDWWDDDDDDDDDDDDDDDDD
DDDDDDDDDDDDDDDDDDDWDDDDDDDDDDDDWDDDDDDDDDDDDDDDDDD
DDDDDDDDDDDDDDDDDDDWWDDDDDDDDDDWDDDDDDDDDDDDDDDDDDD
DDDDDDDDDDDDDDDDDDDDDWDDDDDDDDWDDDDDDDDDDDDDDDDDDDD
DDDDDDDDDDDDDDDDDDDDDDWWDDDWWWDDDDDDDDDDDDDDWDDDDDD
DDDDDDDWWWDDDDDDDSSDDDDDWWWWDDDDDSSDDDDDDDWWWDDDDDD
DDDDDDDDDWWDDDDSSSDDDDDDDDDDDDDDDDSSSDDDDWWDDDDDDDD
DDDDDDDDDDWDDDDSDDDDDDDDDDDDDDDDDDDSSDDDWWDDDDDDDDD
DDDDDDDDDDDWDDDSDDDDDDDDDDDD8DDDDDDDDDDDWDDDDDDDDDD
DDDDDDDDDDDWDDDDDDDDD8DDDDDDDDDDDDDDDDDDWDDDDDDDDDD
88888DDDDDDWDDDDDDDDDDDDDDDDDDDDDDDDDDDDWDDDDDDDDDD
DDDDDDDDDDDWDDDDDDDDDDDDDDDDDDDDDDDDDDDDWDDDD888DDD
DDDDDDDDDDDWDDDDDDDDDDDDDDDDDDDDDDDDDDDDWDDDDDD8888
DDDDDDDDDDWDDDDDDDDDDDDDDDDD8DDDDDDDDDDDWDDDDDDDDDD
DDDDDDDDDDWDDSDDDDDDDDDDDDDDDDDDDDDDDDDDWWDDDDDDDDD
DDDDDDDDDWWDDDSDDDDDD8DDDDDDDDDDDDDDDDDDDWWDDDDDDDD
DDDDDWWWWWDDDDDSDDWWWWWWWWWDDDDDDDDDDSDDDDWWDDDDDDD
DDDDDDDDDDDDDDDDDWWDDDDDDDWWDDDDDDDDSDDDDDDWWDDDDDD
DDDDDDDDDDDDDDDDWWDDDDDDDDDWWDDDDDDSDDDDDDDDDDDDDDD
DDDDDDDDDDDDDDDDWDDDDDDDDDDDWDDDDSSDDDDDDDDDDDDDDDD
DDDDDDDDDDDDDDDDWDDDDDDDDDDDWWDDDDDDDDDDDDDDDDDDDDD
DDDDDDDDDDDDDDDDWDDDDDDDDDDDDWDDDDDDDDDDDDDDDDDDDDD
DDDDDDDDD8DDDDDDDDDDDDDDDDDDDWDDDDDDDDDDDDDDDDDDDDD
DDDDDDDDDDDDDDDDDDDDDDD8DDDDDWDDDDDDDDDDDDDDDDDDDDD
DDDDDDDDDDDDDDDDDDDDDD88DDDDDDDDDDDDDDDDDDD8DDDDDDD
DDDDDDDDDDDDDDDDDDDDDD8DDDDDDDDDDDDDDDDDDDDDDDDDDDD
DDDDDDDDDDDDDDDDDDDDDD8DDDDDDDDDDDDDDDDDDDDDDDDDDDD
